12x9x10
A=0:0;C=5:1;D=64:2;E=58:0;F=54:4;G=54:2;H=54:3;I=54:5;J=85:0;K=64:8;L=64:9;M=68:2;N=68:3;O=68:5;P=20:0;Q=134:4;R=134:6;S=134:7;T=134:5;U=134:3;V=134:1;W=134:2;X=134:0;Y=126:1;Z=125:1;AU=OMGminecraft;
CCCC*DD*CCCCCEFFAAAAFFECCGAAAAAAAAHCCGAAAAAAAAHCCAAAAAAAAAACCGAAAAAAAAHCCGAAAAAAAAHCCEIIAIIAIIECCCCCCCCCCCCC
*CJJCKLCJJC*CMAAAAAAAANCJAAAAAAAAAAJJAAAAAAAAAAJ*AAAAAAAAAA*JAAAAAAAAAAJJAAAAAAAAAAJCMAAAOOAAANC*CJJC**CJJC*
CCPPCCCCPPCCCAAAAAAAAAACPAAAAAAAAAAPPAAAAAAAAAAPCAAAAAAAAAACPAAAAAAAAAAPPAAAAAAAAAAPCAAAAAAAAAACCCPPCCCCPPCC
CCCCCCCCCCCCC*QQQQQQQQ*CCRAAAAAAAASCCRAAAAAAAASCCRAAAAAAAASCCRAAAAAAAASCCRAAAAAAAASCC*TTTTTTTT*CCCCCCCCCCCCC
UVVVVVVVVVVVUCCCCCCCCCCWUC*QQAAQQ*CWUCRAAAAAASCWUCRAAAAAASCWUCRAAAAAASCWUC*TTTTTT*CWUCCCCCCCCCCWXXXXXXXXXXXW
AAAAAAAAAAAAAUVVCJJCVVVAAUCCCAACCCWAAUC*QQQQ*CWAAUCRAAAASCWAAUC*TTTT*CWAAUCCCCCCCCWAAXXXXXXXXXWAAAAAAAAAAAAA
AAAAAAAAAAAAAAAAYYYYAAAAAAUVZZZZVWAAAAUCCCCCCWAAAAUC****CWAAAAUCCCCCCWAAAAUXXXXXXWAAAAAAAAAAAAAAAAAAAAAAAAAA
AAAAAAAAAAAAAAAAAAAAAAAAAAAAAAAAAAAAAAAVVVVVWAAAAAAUCCCCWAAAAAAXXXXXWAAAAAAAAAAAAAAAAAAAAAAAAAAAAAAAAAAAAAAA
AAAAAAAAAAAAAAAAAAAAAAAAAAAAAAAAAAAAAAAAAAAAAAAAAAAAJAAJAAAAAAAAAAAAAAAAAAAAAAAAAAAAAAAAAAAAAAAAAAAAAAAAAAAA
AAAAAAAAAAAAAAAAAAAAAAAAAAAAAAAAAAAAAAAAAAAAAAAAAAAA****AAAAAAAAAAAAAAAAAAAAAAAAAAAAAAAAAAAAAAAAAAAAAAAAAAAA
