6x10x7
A=0:0;C=4:0;D=35:8;E=61:4;F=54:4;G=64:1;H=64:2;I=64:5;J=53:1;K=50:4;L=64:9;M=64:10;N=64:13;O=20:0;P=5:0;Q=44:2;R=53:0;S=85:0;T=44:3;AU=Subby72;
$CCCCCCDDDDCCDDDDCCDDDDCCDDDDCCCDDCCCEFFECCAAAACCAAAAGCCCCCC
CCHICCCAAAACCA!AACCAAAACCAAAACCCAACCCEJJECCKAAACCAAAALCCCCCC
CCMNCCCAAAACOAAAAOOAAAAOCAAAACCCAACCCPAAPCCPQQPCCPPPPCCCCCCC
CCCCCCC*PPPCCPPPPCCPPPPCCPPP*CCRAARCCAAAACCAAAACCAAAACCCCCCC
CPPPPCPAAAAPPAAAAPPAAAAPCASSACCAAAACOAAAAOPAAAAPOAAAAOCPOOPC
CPOOPCPAAAAPOAAAAOPAAAAPCAAAACCAAAACCAAAACCAAAACCAAAACCCCCCC
TTTTTTTTTTTTTTTTTTTTTTTTTTTTTTTTTTTTTTTTTTTTTTTTTTTTTTTTTTTT
